00 00 00 00 00 00 00 00 00 00 00 00 00 00 00 00 00 00 00 00 00 00 00 00 00 00 00 00 00 00 00 00 00 00 00 00 00 00 00 00 00 00 00 00 00 00 00 00 00 00 00 00 00 00
00 01 01 01 01 01 01 01 01 01 01 01 00 01 01 01 01 00 01 01 01 01 23 10 01 01 01 01 01 01 01 01 10 01 01 01 00 01 01 16 16 16 16 16 01 01 01 01 01 01 01 01 01 00
00 01 01 01 01 01 01 01 01 01 01 01 00 01 01 06 01 00 01 04 04 04 01 10 01 05 05 05 07 01 01 01 10 01 01 01 00 01 01 01 01 01 01 01 01 01 01 01 01 02 02 03 01 00
00 01 01 14 01 01 01 01 01 01 01 01 00 01 01 01 01 00 01 04 13 04 01 10 01 05 05 01 08 01 01 01 10 01 01 01 01 01 01 01 01 01 01 01 01 01 01 01 01 02 01 01 01 00
00 01 01 02 01 01 02 02 02 02 02 02 21 01 01 01 01 00 01 04 13 04 01 10 01 05 01 01 01 01 01 01 02 02 02 02 02 02 02 02 02 02 02 02 02 02 02 02 02 02 01 01 01 00
00 01 16 02 16 16 02 16 01 01 02 01 00 01 01 01 01 00 01 04 13 04 01 10 01 01 01 12 01 01 01 01 10 01 02 01 01 01 01 01 01 01 01 01 01 01 01 01 01 02 01 01 16 00
00 01 16 02 16 16 02 16 01 01 02 01 00 01 01 01 01 00 01 04 13 04 01 10 01 01 01 11 01 01 07 01 10 01 02 01 00 00 00 00 00 00 00 00 00 00 00 00 01 02 01 01 16 00
00 01 16 02 02 02 02 16 01 01 02 01 00 17 01 01 18 00 01 04 04 04 01 10 01 01 01 01 01 01 08 01 10 01 02 01 00 18 18 18 18 06 01 01 01 01 01 00 01 02 01 01 16 00
00 01 16 16 16 16 16 16 01 01 02 01 00 01 19 01 18 00 01 01 01 01 01 10 01 01 01 01 01 01 01 01 10 01 02 01 00 18 01 01 01 01 01 01 01 01 01 00 01 02 01 01 16 00
00 01 01 01 01 01 01 01 01 01 02 01 00 01 01 01 18 00 01 01 01 01 01 01 01 01 01 01 01 01 01 01 10 01 02 01 00 18 01 19 01 01 01 01 01 01 01 21 02 02 01 01 01 00
00 01 01 01 01 01 01 01 01 01 02 01 00 18 18 18 18 00 09 09 09 09 09 09 09 09 09 09 09 09 09 09 09 01 02 01 00 18 01 01 01 17 01 01 01 27 01 00 01 01 01 01 01 00
00 00 00 00 00 00 00 00 00 01 02 01 00 00 00 00 00 00 01 01 01 01 01 01 01 01 01 01 01 01 01 01 01 01 02 01 00 00 00 00 00 00 00 00 00 00 00 00 00 00 00 00 00 00
00 01 01 01 01 01 01 01 01 01 02 01 01 01 01 01 01 01 01 01 01 01 01 01 01 01 01 01 01 01 01 01 01 01 02 01 01 01 01 01 01 01 01 01 01 01 01 01 01 01 01 01 01 00
00 01 03 01 01 01 01 01 01 01 02 01 01 01 01 01 01 01 01 01 01 01 01 01 01 01 01 01 01 01 01 01 01 01 02 01 01 01 01 01 01 01 01 01 01 01 01 01 01 01 01 01 01 00
00 01 01 01 01 01 01 01 01 01 02 02 02 02 02 02 02 02 02 02 02 02 02 01 01 01 01 22 01 01 01 02 02 02 02 02 02 02 02 02 02 02 02 02 02 02 02 02 02 02 01 01 01 00
00 01 01 01 01 01 01 01 01 01 01 01 01 01 01 01 01 01 01 02 01 01 01 01 01 01 01 01 01 01 01 01 01 01 01 01 01 01 01 01 01 01 01 01 01 01 01 01 01 02 01 01 01 00
00 01 01 01 01 01 01 01 01 01 01 01 01 01 01 01 01 01 01 02 01 01 01 01 01 01 01 01 01 01 01 01 01 01 01 01 01 01 01 01 01 01 01 01 01 01 01 01 01 02 01 01 01 00
00 00 00 00 00 00 00 00 00 00 00 00 00 00 00 00 00 00 01 02 01 01 01 01 01 01 01 01 01 01 01 01 01 01 01 01 00 00 00 00 00 00 00 00 00 00 00 00 01 02 01 00 00 00
00 01 01 01 01 00 18 18 18 18 01 01 01 01 01 01 01 00 01 02 01 09 09 09 09 09 09 09 09 09 09 09 09 09 09 09 00 01 01 01 01 01 18 18 18 18 00 01 01 02 01 01 01 00
00 01 01 01 01 00 18 01 01 01 01 01 01 01 01 01 01 00 01 02 01 10 01 01 01 01 01 01 01 01 01 01 01 01 01 01 00 01 06 01 01 01 01 01 01 18 00 01 01 02 01 01 16 00
00 01 03 01 01 00 18 01 19 01 01 25 01 01 06 01 01 00 01 02 01 10 01 05 05 05 01 01 01 01 01 01 01 01 01 01 00 01 01 01 01 01 01 19 01 18 00 01 01 02 01 01 16 00
00 01 02 01 16 00 18 01 01 17 01 01 01 01 01 01 01 00 01 02 01 10 01 05 05 01 01 01 01 01 10 01 01 01 01 01 00 01 01 01 26 01 17 01 01 18 00 01 01 02 01 01 16 00
00 01 02 01 16 00 01 01 01 01 01 01 01 01 01 01 01 00 01 02 01 10 01 05 01 01 01 07 01 01 10 01 04 04 04 01 00 01 01 01 01 01 01 01 01 01 00 01 01 02 01 01 16 00
00 01 02 01 16 00 01 01 01 01 01 01 01 01 01 01 01 00 01 02 01 10 01 01 01 01 01 08 01 01 10 01 04 13 04 01 00 01 01 01 01 01 01 01 01 01 00 01 01 02 01 01 01 00
00 01 02 01 16 00 00 24 00 00 00 00 00 00 00 00 00 00 01 02 01 10 01 01 01 01 01 01 01 01 10 01 04 13 04 01 00 00 00 24 00 00 00 00 00 00 00 01 01 02 01 01 01 00
00 01 02 01 01 01 01 02 01 01 01 01 01 01 01 01 01 01 01 02 01 10 01 01 01 12 01 01 01 01 10 01 04 13 04 01 00 01 01 02 01 01 01 01 01 01 01 01 01 02 01 01 01 00
00 01 02 02 02 02 02 02 02 02 02 02 02 02 02 02 02 02 02 02 02 02 01 01 01 11 01 01 01 01 10 01 04 13 04 01 00 01 01 02 01 01 01 01 01 01 01 01 01 02 01 01 01 00
00 01 01 01 01 01 01 01 01 01 01 01 01 01 01 01 01 01 01 01 01 10 01 01 01 01 01 01 01 07 10 01 04 04 04 01 00 01 01 02 02 02 02 02 02 02 02 02 02 02 02 03 01 00
00 01 01 01 01 01 01 01 01 01 01 01 01 01 01 01 01 00 01 01 01 10 01 01 01 01 01 01 01 08 10 23 01 01 01 01 00 01 01 01 01 01 01 01 01 01 01 01 01 01 01 01 01 00
00 00 00 00 00 00 00 00 00 00 00 00 00 00 00 00 00 00 00 00 00 00 00 00 00 00 00 00 00 00 00 00 00 00 00 00 00 00 00 00 00 00 00 00 00 00 00 00 00 00 00 00 00 00